64,61,61,61,61,61,61,61,61,61,61,61,61,65
30,0,0,0,0,0,0,0,0,0,0,0,0,30
30,0,0,0,0,0,0,0,0,0,0,0,0,30
30,0,0,0,0,0,0,0,0,0,0,0,0,30
30,0,0,0,0,0,0,0,0,0,0,0,0,30
30,0,0,0,0,0,0,0,0,0,0,0,0,30
30,0,0,0,0,0,0,0,0,0,0,0,0,30
30,0,0,0,0,0,0,0,0,0,0,0,0,30
30,0,0,0,0,0,0,0,0,0,0,0,0,30
74,61,61,61,61,61,61,61,61,61,61,61,61,75
